11111111
100000C1
1P000111
100001E1
10000111
11111111