11111111
1P0C0011
100000E1
11111111