11111111
100000C1
10000111
1P000001
10000111
10000111
10000111
11111111